{
    "data": [
        "WWWWWWWWWWWWWWWWWWWWWWWWWWWWWWWW",
        "RFFFFFFFFFFLWRFFFFFFFFFFFFFFFFFL",
        "WWWWWWWWWRFFBFFLWWWWWWWWWWWWWWWW",
        "WWWWWWWWWRFFFFFLWWWWWWWWWWWWWWWW",
        "WWWWWWWWWWWWWWWWWWWWWWWWWWWWWWWW",
        "WWWWWWWWWWWWWWWWWWWWWWWWWWWWWWWW",
        "WWWWWWWWWWWWWWWWWWWWWWWWWWWWWWWW",
        "WWWWWWWWWWWWWWWWWWWWWWWWWWWWWWWW",
        "WWWWWWWWWWWWWWWWWWWWWWWWWWWWWWWW",
        "WWWWWWWWWWWWWWWWWWWWWWWWWWWWWWWW",
        "WWWWWWWWWWWWWWWWWWWWWWWWWWWWWWWW",
        "WWWWWWWWWWWWWWWWWWWWWWWWWWWWWWWW",
        "WWWWWWWWWWWWWWWWWWWWWWWWWWWWWWWW",
        "WWWWWWWWWWWWWWWWWWWWWWWWWWWWWWWW",
        "WWWWWWWWWWWWWWWWWWWWWWWWWWWWWWWW",
        "WWWWWWWWWWWWWWWWWWWWWWWWWWWWWWWW",
        "WWWWWWWWWWWWWWWWWWWWWWWWWWWWWWWW",
        "WWWWWWWWWWWWWWWWWWWWWWWWWWWWWWWW",
        "WWWWWWWWWWWWWWWWWWWWWWWWWWWWWWWW",
        "WWWWWWWWWWWWWWWWWWWWWWWWWWWWWWWW",
        "WWWWWWWWWWWWWWWWWWWWWWWWWWWWWWWW",
        "WWWWWWWWWWWWWWWWWWWWWWWWWWWWWWWW",
        "WWWWWWWWWWWWWWWWWWWWWWWWWWWWWWWW",
        "WWWWWWWWWWWWWWWWWWWWWWWWWWWWWWWW",
        "WWWWWWWWWWWWWWWWWWWWWWWWWWWWWWWW",
        "WWWWWWWWWWWWWWWWWWWWWWWWWWWWWWWW",
        "WWWWWWWWWWWWWWWWWWWWWWWWWWWWWWWW",
        "WWWWWWWWWWWWWWWWWWWWWWWWWWWWWWWW",
        "WWWWWWWWWWWWWWWWWWWWWWWWWWWWWWWW",
        "WWWWWWWWWWWWWWWWWWWWWWWWWWWWWWWW",
        "WWWWWWWWWWWWWWWWWWWWWWWWWWWWWWWW",
        "WWWWWWWWWWWWWWWWWWWWWWWWWWWWWWWW"
    ],
    "player": {
        "start": { "x": 32, "y": 16 }
    }
}