{
    "data": [
        "WWWWWWWWWWWWWWWWWWWWWWWWWWWWWWWW",
        "WFFFFFFFFFFFFFFFFFFFFFFFFFFFFFFW",
        "WWWWWWWWWWWWWWWWWWWWWWWWWWWWWWWW",
        "WWWWWWWWWWWWWWWWWWWWWWWWWWWWWWWW",
        "WWWWWWWWWWWWWWWWWWWWWWWWWWWWWWWW",
        "WWWWWWWWWWWWWWWWWWWWWWWWWWWWWWWW",
        "WWWWWWWWWWWWWWWWWWWWWWWWWWWWWWWW",
        "WWWWWWWWWWWWWWWWWWWWWWWWWWWWWWWW",
        "WWWWWWWWWWWWWWWWWWWWWWWWWWWWWWWW",
        "WWWWWWWWWWWWWWWWWWWWWWWWWWWWWWWW",
        "WWWWWWWWWWWWWWWWWWWWWWWWWWWWWWWW",
        "WWWWWWWWWWWWWWWWWWWWWWWWWWWWWWWW",
        "WWWWWWWWWWWWWWWWWWWWWWWWWWWWWWWW",
        "WWWWWWWWWWWWWWWWWWWWWWWWWWWWWWWW",
        "WWWWWWWWWWWWWWWWWWWWWWWWWWWWWWWW",
        "WWWWWWWWWWWWWWWWWWWWWWWWWWWWWWWW",
        "WWWWWWWWWWWWWWWWWWWWWWWWWWWWWWWW",
        "WWWWWWWWWWWWWWWWWWWWWWWWWWWWWWWW",
        "WWWWWWWWWWWWWWWWWWWWWWWWWWWWWWWW",
        "WWWWWWWWWWWWWWWWWWWWWWWWWWWWWWWW",
        "WWWWWWWWWWWWWWWWWWWWWWWWWWWWWWWW",
        "WWWWWWWWWWWWWWWWWWWWWWWWWWWWWWWW",
        "WWWWWWWWWWWWWWWWWWWWWWWWWWWWWWWW",
        "WWWWWWWWWWWWWWWWWWWWWWWWWWWWWWWW",
        "WWWWWWWWWWWWWWWWWWWWWWWWWWWWWWWW",
        "WWWWWWWWWWWWWWWWWWWWWWWWWWWWWWWW",
        "WWWWWWWWWWWWWWWWWWWWWWWWWWWWWWWW",
        "WWWWWWWWWWWWWWWWWWWWWWWWWWWWWWWW",
        "WWWWWWWWWWWWWWWWWWWWWWWWWWWWWWWW",
        "WWWWWWWWWWWWWWWWWWWWWWWWWWWWWWWW",
        "WWWWWWWWWWWWWWWWWWWWWWWWWWWWWWWW",
        "WWWWWWWWWWWWWWWWWWWWWWWWWWWWWWWW"
    ]
}