{
    "data": [
        "WWWWWWWWWWWWWWWWWWWWWWWWWWWWWWWW",
        "RFFFFFFFFFFLWRFFFFFFFFFFFFFFFFFL",
        "RFFFFFFFLRFFBFFLWWWWWWWWWWWWWWWW",
        "RFFFFFFFFFFFFFFLWWWWWWWWWWWWWWWW",
        "RFFFFFFFLRFFFFFFFFFFFFFFFFFFFFFW",
        "RFFFFFFFFFFFFFFFFFFFFFFFFFFFFFFW",
        "RFFFFFFFFFFFFFFFFFFFFFFFFFFFFFFW",
        "RFFFFFFFFFFFFFFFFFFFFFFFFFFFFFFW",
        "WWWWWWWWWWWWWWWWWWWWWWWWWWWWWWWW",
        "WWWWWWWWWWWWWWWWWWWWWWWWWWWWWWWW",
        "WWWWWWWWWWWWWWWWWWWWWWWWWWWWWWWW",
        "WWWWWWWWWWWWWWWWWWWWWWWWWWWWWWWW",
        "WWWWWWWWWWWWWWWWWWWWWWWWWWWWWWWW",
        "WWWWWWWWWWWWWWWWWWWWWWWWWWWWWWWW",
        "WWWWWWWWWWWWWWWWWWWWWWWWWWWWWWWW",
        "WWWWWWWWWWWWWWWWWWWWWWWWWWWWWWWW",
        "WWWWWWWWWWWWWWWWWWWWWWWWWWWWWWWW",
        "WWWWWWWWWWWWWWWWWWWWWWWWWWWWWWWW",
        "WWWWWWWWWWWWWWWWWWWWWWWWWWWWWWWW",
        "WWWWWWWWWWWWWWWWWWWWWWWWWWWWWWWW",
        "WWWWWWWWWWWWWWWWWWWWWWWWWWWWWWWW",
        "WWWWWWWWWWWWWWWWWWWWWWWWWWWWWWWW",
        "WWWWWWWWWWWWWWWWWWWWWWWWWWWWWWWW",
        "WWWWWWWWWWWWWWWWWWWWWWWWWWWWWWWW",
        "WWWWWWWWWWWWWWWWWWWWWWWWWWWWWWWW",
        "WWWWWWWWWWWWWWWWWWWWWWWWWWWWWWWW",
        "WWWWWWWWWWWWWWWWWWWWWWWWWWWWWWWW",
        "WWWWWWWWWWWWWWWWWWWWWWWWWWWWWWWW",
        "WWWWWWWWWWWWWWWWWWWWWWWWWWWWWWWW",
        "WWWWWWWWWWWWWWWWWWWWWWWWWWWWWWWW",
        "WWWWWWWWWWWWWWWWWWWWWWWWWWWWWWWW",
        "WWWWWWWWWWWWWWWWWWWWWWWWWWWWWWWW"
    ],
    "player": {
        "start": { "x": 32, "y": 16 }
    }
}